EEEEEEEAEE
EEEWWWWWEE
EEEEEEEWEE
WWWWEEWEEE
EEEEEEWEEE
WWWEEWWWEE
EEEEEWEEWE
WWWEWEEEWE
EEEEEEEEEE
DEEEEEEEEE